9,9
#####P###
# II I#C#
#####I#C#
# CC C#I#
# ### #C#
#II #C#I#
### # # #
#   #  I#
###E#####
