9,9
###E#####
#       #
####### #
#       #
# ### # #
#   # # #
##### # #
#     # #
#######P#
