9,21
###E#####
#  I    #
# ##### #
# I #   #
### ###I#
#   #   #
#####C###
#I I#   #
### #C# #
# #C# # #
#C#C#C# #
# # IC# #
# ### # #
#   #I#C#
###C# #I#
# # # # #
# # # # #
#   # # #
# ### # #
#     #I#
###P#####
