15,17
###############
# #     #   C #
# #I### #C# #I#
#I#I  #  I# #I#
# ### ##### # #
E     # II#C#I#
#######I# #C# #
#C    # #   # #
### # # #C###I#
# I #C  # C # #
# ######### # #
#     # #   #I#
##### #I##### #
#  I#   #  I# #
# #I### # ###I#
#C#  I  #I    P
###############
